15.ox
...........oo..
...o........oo.
...............
..o.o..o....o..
.........o....o
.....o....o.o..
..........o....
.o....o.o.....o
..o..........o.
.............o.
..........o.o..
...o..oo..oo...
.o..o.o........
..o............
.......o...o...
